R	700 700

NO ./textures/colorstone.xpm
SO    textures/greystone.xpm
WE      textures/redbrick.xpm
EA        textures/wood.xpm
S           textures/barrel.xpm

C 25,5,100
F 75,0,130

        1111111111111111111111111
        1000000000110000000000001
        1011000001110000202000001
        10000000000000000W0000001
111111111011000001110000202000001
100000000011000001110111111111111
11110111111111011100000000001
11110111111111011101010000001
11000000110101011100000010001
10002000000111001100000012101
100000000001 1001101110010001
110000011101 1011111 1111000111
11110111 1110101 101111010001
11111111 1111111 111111111111
		